3600,1500,15,30,0,5,0,0,0,
2,0,0,90,150,100,0,9,0,
3,0,150,150,400,100,0,9,0,
4,0,300,150,400,100,0,9,0,
4,20,0,15,30,90,0,9,0,
23,0,13500,13500,13500,100,9,9,0,
0,0,0,0,0,0,0,9,0,
0,0,0,0,0,0,0,9,0,
0,0,0,0,0,0,0,9,0,
0,0,0,0,0,0,0,9,0,
0,0,0,0,0,0,0,9,0,
0,0,0,0,0,0,0,9,0,
0,0,0,0,0,0,0,9,0,
0,0,0,0,0,0,0,9,0,
0,0,0,0,0,0,0,9,0,
0,0,0,0,0,0,0,9,0,
0,0,0,0,0,0,0,9,0,
0,0,0,0,0,0,0,9,0,
0,0,0,0,0,0,0,9,0,
0,0,0,0,0,0,0,9,0,
0,0,0,0,0,0,0,9,0,
